#Copyright (ja-jp): Copyright (c) shogo82148
#Description (ja-jp): 長岡技術科学大学の学食で提供されているメニューを簡単に入力するための辞書です。
#GUID: {499acb1d-111c-4171-9055-4b00e59ec742}
#Language: ja-jp
#Long Name (ja-jp): 長岡技術科学大学食堂メニュー辞書
#Short Name (ja-jp): 技大食堂辞書
#Source URL: http://github.com/shogo82148/gakushoku-dic/
#Version: 1
200ぐらむのおっきなちきんすてーきどん	200グラムのおっきなチキンステーキ丼	名詞
５４５えんていしょく	545円定食	名詞
５４５えんどん	545円丼	名詞
５４５せっと	545セット	名詞
５４５ていしょく	545定食	名詞
あげぎょーざ	揚げギョーザ	名詞
あげぎょーざ	揚げ餃子	名詞
あげぎょーざちゅうかあん	揚げ餃子中華あん	名詞
あげぎょーざのあんかけ	揚げギョーザのあんかけ	名詞
あげぎょーざのちゅうかあん	揚餃子の中華あん	名詞
あげぎょうざ	揚げ餃子	名詞
あげぎょうざのあんかけ	揚げギョーザのあんかけ	名詞
あげぎょうざのちゅうかあん	揚げ餃子の中華あん	名詞
あげさかなのにおろしかけ	揚げ魚の煮おろしかけ	名詞
あげしゅーまい	揚シューマイ	名詞
あげしゅうまい	揚シューマイ	名詞
あげだしどうふさんさいあんかけ	揚げ出し豆腐山菜あんかけ	名詞
あげとうふのうまに	揚げ豆腐の旨煮	名詞
あげとうふのかいせんあんかけ	揚げ豆腐の海鮮あんかけ	名詞
あげとうふのぶたにくあんかけ	揚げ豆腐の豚肉あんかけ	名詞
あげとうふのまーぼーどん	揚げ豆腐の麻婆丼	名詞
あげとうふのみぞれあんかけ	揚げ豆腐のみぞれあんかけ	名詞
あげとうふみぞれあんかけ	揚げ豆腐みぞれあんかけ	名詞
あげとうふもみじおろしあんかけ	揚げ豆腐もみじおろしあんかけ	名詞
あげどうふかいせんあんかけ	揚げ豆腐海鮮あんかけ	名詞
あげどうふとりにくあんかけ	揚げ豆腐鶏肉あんかけ	名詞
あげどうふのぶたにくあんかけ	揚豆腐の豚肉あんかけ	名詞
あげどうふぶたにくあんかけ	揚げ豆腐豚肉あんかけ	名詞
あげどうふみぞれあんかけ	揚げ豆腐 みぞれあんかけ	名詞
あげどりのあまずあんからめ	揚げ鶏の甘酢あんからめ	名詞
あげどりのおろしあえ	揚げ鶏のおろし和え	名詞
あげどりのもみじおろしあえ	揚げ鶏のもみじおろし和え	名詞
あげなすのしせんふううまに	揚げ茄子の四川風旨煮	名詞
あげなすのしょうがじょうゆ	揚げ茄子の生姜醤油	名詞
あげなすのちゅうかあん	揚げ茄子の中華あん	名詞
あじつきとりあま	味付きトリ天	名詞
あじなんばんづけ	アジ南蛮漬け	名詞
あじのちーずまきあげ	アジのチーズ巻き揚げ	名詞
あじのなんばんずけ	アジの南蛮漬け	名詞
あじふらいたるたるそーす	アジフライタルタルソース	名詞
あじふらいとつなさらだ	アジフライとツナサラダ	名詞
あじふらいのおろしかけ	アジフライのおろしかけ	名詞
あつあげとやさいのみそいため	厚揚げと野菜の味噌炒め	名詞
あつあげのおいすたーそーすいため	厚揚げのオイスターソース炒め	名詞
あぶらそば	油そば	名詞
あんかけちゃーはん	あんかけチャーハン	名詞
いかやさいかつ	イカ野菜カツ	名詞
いしかりじる	石狩汁	名詞
いしかりどん	石狩丼	名詞
いしやきちーずかれー	石焼チーズカレー	名詞
いたりあふうちきんかつどん	イタリア風チキンカツ丼	名詞
いたりあんはんばーぐ	イタリアンハンバーグ	名詞
いちぴんしょうぶ！きむかるじゃない・・・	一品勝負！キムカルじゃない・・・	名詞
いっぴんしょうぶ	1品勝負!	名詞
いっぴんしょうぶ	一品勝負！	名詞
いっぴんしょうぶ！きむかるじゃない	一品勝負！キムカルじゃない	名詞
いりどり	いりどり	名詞
いんげんのわふうそてー	インゲンの和風ソテー	名詞
いんげんわふうそてー	インゲン和風ソテー	名詞
いんでぃーちきん	インディーチキン	名詞
ういんなーそてー	ウインナーソテー	名詞
ういんなーとじゃがいものちりそーす	ウインナーとじゃが芋のチリソース	名詞
うしきむちいためていしょく	牛キムチ炒め定食	名詞
うしやきとおむれつ	牛焼きとオムレツ	名詞
うずらたまごとやさいのごめに	うずら卵と野菜の五目煮	名詞
うみのさちうどん	海の幸うどん	名詞
えっぐかれーらいす	エッグカレーライス	名詞
えっぐはんばーぐ	エッグハンバーグ	名詞
えっぐやきにく	エッグ焼肉	名詞
えびからていしょく	海老から定食	名詞
えびぐらころっけ	海老グラころっけ	名詞
えびぐらころっけ	海老グラコロッケ	名詞
えびぐらたんころっけ	海老グラタンコロッケ	名詞
えびちりたまご	エビチリたまご	名詞
えびふうみぐらたんころっけ	エビ風味グラタンコロッケ	名詞
えびふらいたるたるそーす	エビフライタルタルソース	名詞
おうさけどん	王鮭丼	名詞
おそうざい	お惣菜	名詞
おそうざいを	お惣菜を	名詞
おそばやさんのかれーどん	お蕎麦屋さんのカレー丼	名詞
おっきなちきんすてーきどん	おっきなチキンステーキ丼	名詞
おでんもりあわせ	おでん盛り合わせ	名詞
おむはやし	オムハヤシ	名詞
おむはやしどん	オムハヤシ丼	名詞
おむらいす	オムライス	名詞
おやこかれー	親子カレー	名詞
おやこどん	親子丼	名詞
おやこに	親子煮	名詞
おろしちきんかつ	おろしチキンカツ	名詞
おろしはんばーぐ	おろしハンバーグ	名詞
おろしばーぐ	おろしバーグ	名詞
おろしひれかつ	おろしヒレカツ	名詞
おろしぶたかつ	おろし豚カツ	名詞
おろしやきにく	おろし焼肉	名詞
おんたまかれーらいす	温たまカレーライス	名詞
おんたまかれーらいす	温玉カレーライス	名詞
おんたまきーまかれー	温玉キーマカレー	名詞
おんたまきーまかれーらいす	温玉キーマカレーライス	名詞
おんたまのせしょうがやきどん	温たまのせ生姜焼き丼	名詞
かたやきそば	かた焼きそば	名詞
かつおのさししどん	鰹の刺し丼	名詞
かつに	カツ煮	名詞
かに	カニ	名詞
かにぎょくどん	かに玉丼	名詞
かにくりーむころっけ	かにクリームコロッケ	名詞
かにたまころっけ	かに玉コロッケ	名詞
かにたまところっけ	かに玉とコロッケ	名詞
かにたまところっけ	カニ玉とコロッケ	名詞
かにふうみおむれつ	カニ風味オムレツ	名詞
かぼちゃころっけ	かぼちゃコロッケ	名詞
かぼちゃちーずやき	かぼちゃチーズ焼き	名詞
かぼちゃとちーずやき	かぼちゃとチーズ焼き	名詞
かぼちゃのそぼろあんかけ	かぼちゃのそぼろあんかけ	名詞
かぼちゃのちーずやき	かぼちゃのチーズ焼き	名詞
からあげすっいーとちりていしょく	唐揚げスッイートチリ定食	名詞
からあげのかれーちー	唐揚げのカレーチー	名詞
からあげのちゅうからびこっとそーす	唐揚げの中華ラビコットソース	名詞
からあげのちゅうからぴこっとそーす	唐揚げの中華ラピコットソース	名詞
からあげのれもんぺっぱー	唐揚げのレモンペッパー	名詞
からあげれもんぺっぱー	カラ揚げレモンペッパー	名詞
からあげれもんぺっぱー	唐揚げレモンペッパー	名詞
からみそちきん	辛みそチキン	名詞
かりふらわーときゃべつのかれーそてー	カリフラワーとキャベツのカレーソテー	名詞
かれーころっけ	カレーコロッケ	名詞
かれーちーまよ	カレーチーマヨ	名詞
かれーなんばん	カレー南蛮	名詞
かれーなんばんとやきにくどん	カレー南蛮と焼肉丼	名詞
かわりおむれつ	変わりオムレツ	名詞
かわりおやこどん	変わり親子丼	名詞
がーりっくちきん	ガーリックチキン	名詞
がーりっくぽてと	ガーリックポテト	名詞
がっつりまん	ガッツリマン	名詞
がんそかるきむどん	元祖カルキム丼	名詞
きーまかれー	キーマカレー	名詞
きじまよどん	キジマヨ丼	名詞
きじみそまよどん	きじミソマヨ丼	名詞
きじやきどん	きじ焼き丼	名詞
きじやきどんみそ	きじ焼き丼ミソ	名詞
きじやきどんみそ	きじ焼き丼味噌	名詞
きじやきどんみそ	キジ焼き丼ミソ	名詞
きむちふうさらだ	キムチ風サラダ	名詞
きむちもやし	キムチもやし	名詞
きむちやきにく	キムチ焼肉	名詞
きむまよちきん	キムマヨチキン	名詞
きんぐさーもんどん	キングサーモン丼	名詞
ぎゅうきむちいためていしょく	牛キムチ炒め定食	名詞
ぎゅうにくとごぼうのいため	牛肉とごぼうの炒め	名詞
ぎゅうにくとにんにくのめのいため	牛肉とニンニクの芽の炒め	名詞
ぎゅうにくとやさいのいため	牛肉と野菜の炒め	名詞
ぎゅうにくのからみそどん	牛肉の辛味噌丼	名詞
ぎゅうやとおむれつ	牛焼とオムレツ	名詞
ぎょーざすーぷ	ギョーザスープ	名詞
ぎょーざのしせんふううまに	ギョーザの四川風旨煮	名詞
ぎょうざすーぷ	餃子スープ	名詞
ぎんじゃけのむにえるくりーむそーすきのこぞえ	銀鮭のムニエルクリームソースきのこ添え	名詞
くりーむしちゅー	クリームシチュー	名詞
くるまぶのおとしに	車麩の落とし煮	名詞
くるまぶのおとしに	車麸の落とし煮	名詞
ぐりるどちきんいたりあふう	グリルドチキンイタリア風	名詞
けいにくきむちやき	鶏肉キムチ焼き	名詞
けいにくごまふうみやき	鶏肉ゴマ風味焼き	名詞
けいにくときのこのちゃーはん	鶏肉ときのこのチャーハン	名詞
けいにくとさといものあげに	鶏肉と里芋の揚げ煮	名詞
けいにくとさといものにもの	鶏肉と里芋の煮物	名詞
けいにくとじゃがいものあんからめ	鶏肉とじゃが芋のあんからめ	名詞
けいにくとたけのこのうまに	鶏肉とタケノコの旨煮	名詞
けいにくとちーずやき	鶏肉とチーズ焼き	名詞
けいにくとぶろっこりーいため	鶏肉とブロッコリー炒め	名詞
けいにくとぶろっこりーのいため	鶏肉とブロッコリーの炒め	名詞
けいにくとほうれんそうのいため	鶏肉とほうれん草の炒め	名詞
けいにくとまめいたびしおあえ	鶏肉と豆板醤和え	名詞
けいにくとみそずけやき	鶏肉と味噌漬け焼き	名詞
けいにくとやさいのごめいため	鶏肉と野菜の五目炒め	名詞
けいにくとやんぐこーんのまめいたびしおいため	鶏肉とヤングコーンの豆板醤炒め	名詞
けいにくのいためもの	鶏肉の炒め物	名詞
けいにくのかれーくりーむに	鶏肉のカレークリーム煮	名詞
けいにくのがーりっくやき	鶏肉のガーリック焼き	名詞
けいにくのごまてりやき	鶏肉のごま照り焼き	名詞
けいにくのさんいろあげ	鶏肉の三色揚げ	名詞
けいにくのしせんふうさらだ	鶏肉の四川風サラダ	名詞
けいにくのすぶたふう	鶏肉の酢豚風	名詞
けいにくのちーずやき	鶏肉のチーズ焼き	名詞
けいにくのちゅうかふうさらだ	鶏肉の中華風サラダ	名詞
けいにくのてりやきどん	鶏肉の照り焼き丼	名詞
けいにくのなんばんあげ	鶏肉の南蛮揚げ	名詞
けいにくのまめいたびしおあえ	鶏肉の豆板醤和え	名詞
けいにくのまめいたびしおいため	鶏肉の豆板醤炒め	名詞
けいにくのみそずけやき	鶏肉の味噌漬け焼き	名詞
けいにくぴりからみそやき	鶏肉ピリ辛味噌焼き	名詞
けいはん	鶏飯	名詞
けいはん	鶏飯(けいはん)	名詞
けんさんとりにくとあきなすのおろしぽんずぞえ	県産鶏肉と秋なすのおろしポン酢添え	名詞
けんさんとりにくのからあげ	県産鶏肉の唐揚げ	名詞
けんちんしる	けんちん汁	名詞
こーん	コーン	名詞
こくさんささみふらい	国産ササミフライ	名詞
こくさんささみふらいすぱいしーたるたるそーす	国産ササミフライスパイシータルタルソース	名詞
こめこのからあげ	米粉の唐揚げ	名詞
こめこのしちゅー	米粉のシチュー	名詞
こめこのすぱいしーからあげ	米粉のスパイシー唐揚げ	名詞
こめこのすぱいしーさばからあげ	米粉のスパイシーサバ唐揚げ	名詞
こめこのてんどん	米粉の天丼	名詞
こめこのとりからあげ	米粉の鶏唐揚げ	名詞
こめこのはやしらいす	米粉のハヤシライス	名詞
ころころかれーらいす	ころころカレーライス	名詞
ころころきゃんぷふぁいやーかれー	ころころキャンプファイヤーカレー	名詞
ころっけかれー	コロッケカレー	名詞
ころっけのとまとそーす	コロッケのトマトソース	名詞
ころっけらいす	コロッケライス	名詞
ころっけらいす・けいにくのぴりぴりずけ	コロッケライス・鶏肉のピリピリ漬け	名詞
ごーよんごえんていしょく	545円定食	名詞
ごーよんごえんどん	545円丼	名詞
ごーよんごせっと	545セット	名詞
ごーよんごていしょく	545定食	名詞
ごーよんごどん	545丼	名詞
ごーよんごどん	545丼	名詞
ごひゃくよんじゅうごえんていしょく	545円定食	名詞
ごひゃくよんじゅうごえんどん	545円丼	名詞
ごひゃくよんじゅうごせっと	545セット	名詞
ごひゃくよんじゅうごていしょく	545定食	名詞
ごひゃくよんじゅうごどん	545丼	名詞
ごめにくじゃが	五目肉じゃが	名詞
ごもくあんかけやきそば	五目あんかけ焼きそば	名詞
ごもくきんぴら	五目金平	名詞
ごもくさらうどん	五目皿うどん	名詞
ごもくじゃがかれーみそ	五目じゃがカレー風味	名詞
ごもくにくじゃがかれーふうみ	五目肉じゃがカレー風味	名詞
ごもくふううどん	五目風うどん	名詞
さーもんぐりる	サーモングリル	名詞
さーもんしちゅー	サーモンシチュー	名詞
さーもんふらい	サーモンフライ	名詞
さーもんふらいおーろらそーす	サーモンフライオーロラソース	名詞
さーもんふらいおろしかけ	サーモンフライおろしかけ	名詞
さーもんふらいこぶさらだふう	サーモンフライコブサラダ風	名詞
さーもんふらいたるたるそーす	サーモンフライタルタルソース	名詞
さーもんふらいとごまふうみさらだ	サーモンフライとゴマ風味サラダ	名詞
さーもんふらいとたまごとじ	サーモンフライと卵とじ	名詞
さーもんふらいとちきんさらだ	サーモンフライとチキンサラダ	名詞
さーもんふらいのたまごとじ	サーモンフライの卵とじ	名詞
さーもんふらいのちーずやき	サーモンフライのチーズ焼き	名詞
さーもんふらいらびこっとそーす	サーモンフライラビコットソース	名詞
さーもんふらいらぴこっとそーす	サーモンフライラピコットソース	名詞
さーもんふりったー	サーモンフリッター	名詞
さかなのさんいろあげ	魚の三色揚げ	名詞
さくさくやさいころっけ	サクサク野菜コロッケ	名詞
さけちゃーはん	鮭チャーハン	名詞
さけちゃづけ	鮭茶漬け	名詞
さけとながおかやさいのあげひたし	鮭と長岡野菜の揚げ浸し	名詞
さけのからあげ	鮭の唐揚げ	名詞
さけのかれーに	鯖のカレー煮	名詞
さけのさわやかそーすかけ	鮭のさわやかソースかけ	名詞
さけのさんしょくあげ	鮭の三色揚げ	名詞
さけのしおやき	鮭の塩焼き	名詞
さけのしおやきとんじる	(鮭の塩焼き・豚汁)	名詞
さけのたつたあげ	鯖の竜田揚げ	名詞
さけのちゃんちゃんやき	鮭のちゃんちゃん焼き	名詞
さけのぴりぴりずけ	鮭のピリピリ漬け	名詞
さけのほいるやき	鮭のホイル焼き	名詞
さけのむにえる	鮭のムニエル	名詞
さけのやさいあんかけ	鮭の野菜あんかけ	名詞
さけほいるやき	鮭ホイル焼き	名詞
さけまりね	鮭マリネ	名詞
ささみふらい	ササミフライ	名詞
ささみふらいとまとそーす	ササミフライトマトソース	名詞
さつまじる	さつま汁	名詞
さといもとけいにくのあげに	里芋と鶏肉の揚げ煮	名詞
さといもととりにくのあげに	里芋と鶏肉の揚げ煮	名詞
さばからあげすぱいしーかれー	サバ唐揚げ<スパイシーカレー>	名詞
さばしおとんじるていしょく	鯖塩トン汁定食	名詞
さばしおやき	鯖塩焼き	名詞
さばのあじみそに	鯖の味味噌煮	名詞
さばのしおやき	鯖の塩焼き	名詞
さばのしょうがやき	鯖の生姜焼き	名詞
さばのみそに	鯖の味噌煮	名詞
さばふらいとしょうがやき	鯖フライと生姜焼き	名詞
さばふらいのすぱいしーたるたるそーす	鯖フライのスパイシータルタルソース	名詞
さらだ	サラダ	名詞
さんさいうどんとみにてんどん	山菜うどんとミニ天丼	名詞
さんさいうどんとやきにくどん	山菜うどんと焼肉丼	名詞
さんしきどん	三色丼	名詞
さんまからみそに	さんま辛味噌煮	名詞
さんまのかばやきふう	サンマの蒲焼風	名詞
さんまのからしみそに	さんまの辛味噌煮	名詞
さんまのやさいあんかけ	サンマの野菜あんかけ	名詞
さんまふらい	サンマフライ	名詞
しーふーどちゃうだー	シーフードチャウダー	名詞
しおにくじゃが	塩肉じゃが	名詞
ししゃもいそべあげ	シシャモ磯辺揚げ	名詞
ししゃものあおのりあげ	シシャモの青のり揚げ	名詞
ししゃものいそべあげ	ししゃもの磯辺揚げ	名詞
ししゃものいそべあげ	シシャモの磯辺揚げ	名詞
ししゃものかれーあげ	シシャモのカレー揚げ	名詞
ししゃものごまふうみてんぷら	シシャモのゴマ風味天ぷら	名詞
ししゃもふらい	シシャモフライ	名詞
しせんそぼろうどん	四川そぼろうどん	名詞
しせんそぼろどん	四川そぼろどん	名詞
しせんそぼろどん	四川そぼろ丼	名詞
しせんふううまに	四川風旨煮	名詞
しゅーまいのあおのりあげ	シューマイの青のり揚げ	名詞
しゅーまいのかれーあげ	シューマイのカレー揚げ	名詞
しゅーまいのちゅうかふううまに	シューマイの中華風旨煮	名詞
しょうがやきとあじふらい	生姜焼きとアジフライ	名詞
しょうがやきところっけ	生姜焼きとコロッケ	名詞
しょうがやきとようぎょーざ	生姜焼きと揚ギョーザ	名詞
しる	汁	名詞
しろみざかなたるたるそーす	白身魚タルタルソース	名詞
しろみざかなちーずやきところっけ	白身魚チーズ焼きとコロッケ	名詞
しろみざかなとちきんさらだ	白身魚とチキンサラダ	名詞
しろみざかなのいそべあげ	白身魚の磯辺揚げ	名詞
しろみざかなのおーろらそーす	白身魚のオーロラソース	名詞
しろみざかなのかれーあげ	白身魚のカレー揚げ	名詞
しろみざかなのけちゃっぷに	白身魚のケチャップ煮	名詞
しろみざかなのごまふうみあげ	白身魚のごま風味揚げ	名詞
しろみざかなのごまふうみあげ	白身魚のゴマ風味揚げ	名詞
しろみざかなのちーずやきところっけ	白身魚のチーズ焼きとコロッケ	名詞
しろみざかなのぴりぴりずけ	白身魚のピリピリ漬け	名詞
しろみざかなのふりったーあげとぽてとさらだ	白身魚のフリッター揚げとポテトサラダ	名詞
しろみざかなのまりね	白身魚のマリネ	名詞
しろみざかなのやさいあんかけ	白身魚の野菜あんかけ	名詞
しろみざかなふらいたるたるそーす	白身魚フライタルタルソース	名詞
しろみざかなふらいとごまふうみさらだ	白身魚フライとゴマ風味サラダ	名詞
しろみざかなふらいとつなさらだ	白身魚フライとツナサラダ	名詞
しろみざかなふらいとぽてとさらだ	白身魚フライとポテトサラダ	名詞
しろみざかなふらいのたまごとじ	白身魚フライの卵とじ	名詞
しろみざかなふらいのちーずやき	白身魚フライのチーズ焼き	名詞
しろみざかなふりったーあげとつなさらだ	白身魚フリッター揚げとツナサラダ	名詞
しろみざかなふりったーあげとぽてとさらだ	白身魚フリッター揚げとポテトサラダ	名詞
しろみざなかふらいおーろらそーす	白身魚フライオーロラソース	名詞
しろみざなかふらいちりそーす	白身魚フライチリソース	名詞
しろみふらい	白身フライ	名詞
しろみふらいたるたるそーす	白身フライタルタルソース	名詞
しろみふらいとまとそーす	白身フライトマトソース	名詞
じばのやさいてんぷら	地場の野菜天ぷら	名詞
じゃがいものちーずいあげ	じゃが芋のチーズ衣揚げ	名詞
じゃんぼえびふらい	ジャンボエビフライ	名詞
じゃんぼさーもんふらい	ジャンボサーモンフライ	名詞
じゃんぼしゅーまいのあんかけ	ジャンボシューマイのあんかけ	名詞
じゃんぼしろみふらい	ジャンボ白身フライ	名詞
じゅーしーめんち	ジューシーメンチ	名詞
すきやきどん	すき焼き丼	名詞
すきやきふうむねに	すき焼き風旨煮	名詞
すこっちえっぐとにわとりからやくみそーすあえ	スコッチエッグと鶏カラ薬味ソース和え	名詞
すたみなぎゅうっとさらだじたて	スタミナ牛〜っとサラダ仕立て	名詞
すたみなしょうがやき	スタミナ生姜焼き	名詞
すたみなちきんかつ	スタミナチキンカツ	名詞
すぱいしーがーりっくちきん	スパイシーガーリックちきん	名詞
すぱいしーたんどりちきん	スパイシータンドリちきん	名詞
すぱいしーちきんかれー	スパイシーチキンカレー	名詞
すぱいしーどらいかれー	スパイシードライカレー	名詞
すぱげてぃーみーとそーす	スパゲティーミートソース	名詞
すぶた	酢豚	名詞
すぺいんふうおむれつところっけ	スペイン風オムレツとコロッケ	名詞
そーすひれかつ	ソースヒレカツ	名詞
そーせーじふらい	ソーセージフライ	名詞
そぼくなていしょく	素朴な定食	名詞
そぼろにしょくどん	そぼろ二色丼	名詞
たいのしおやき	鯛の塩焼き	名詞
たまごとたまねぎのそてー	卵と玉ねぎのソテー	名詞
たまごとたまねぎのそてー	卵と玉ネギのソテー	名詞
たまねぎのがーりっくれもんそてー	玉ねぎのガーリックレモンソテー	名詞
たまねぎのすいーとちりそてー	玉ねぎのスイートチリソテー	名詞
たまねぎのすいーとちりそてー	玉ネギのスイートチリソテー	名詞
たるかつ	タルカツ	名詞
たるたるはさみかつ	タルタルはさみカツ	名詞
たれかつどん	たれカツ丼	名詞
たんどりりきん	タンドリチキン	名詞
だいこんととんびきのあまからいため	大根と豚挽の甘辛炒め	名詞
だいこんとふのそぼろに	大根と麸のそぼろ煮	名詞
だいこんのみそに	大根の味噌煮	名詞
だいにのせいめいせんちきんなんばん	第二の生命線チキン南蛮	名詞
ちーず	チーズ	名詞
ちーずはんばーぐでみそーす	チーズハンバーグデミソース	名詞
ちきんあおのりたつたあげ	チキン青のり竜田揚げ	名詞
ちきんかつ	ちきんカツ	名詞
ちきんかつ	チキンカツ	名詞
ちきんかつかれー	チキンカツカレー	名詞
ちきんかつかれーそーす	チキンカツカレーソース	名詞
ちきんかつごぶさらだふう	チキンカツコブサラダ風	名詞
ちきんかつたるたるそーす	チキンカツタルタルソース	名詞
ちきんかつちりそーす	チキンカツチリソース	名詞
ちきんかつでみそーす	チキンカツデミソース	名詞
ちきんかつとまとそーす	チキンカツトマトソース	名詞
ちきんかつどん	チキンカツ丼	名詞
ちきんかつに	チキンカツ煮	名詞
ちきんかつみらのふう	チキンカツミラノ風	名詞
ちきんかつもみじおろし	チキンカツもみじおろし	名詞
ちきんからあげ	チキン唐揚げ	名詞
ちきんからあげーぺっぱー	チキン唐揚げ＜ペッパー＞	名詞
ちきんからあげすぱいしーかれー	チキン唐揚げ<スパイシーカレー>	名詞
ちきんからあげすぱいしーかれー	チキン唐揚げ＜スパイシーカレー＞	名詞
ちきんからあげちーず	チキン唐揚げ<チーズ>	名詞
ちきんからあげちーず	チキン唐揚げ＜チーズ＞	名詞
ちきんからあげぺっぱー	チキン唐揚げ＜ペッパー＞	名詞
ちきんからあげれっど	チキン唐揚げ＜レッド＞	名詞
ちきんからあげれっど	チキン唐揚げ＜レッド＞	名詞
ちきんかれーあげ	チキンカレー揚げ	名詞
ちきんかれーちー	チキンカレーチー	名詞
ちきんかれーちーずやき	チキンカレーチーズ焼き	名詞
ちきんかれーふうさらだ	チキンカレー風サラダ	名詞
ちきんかれーふうみさらだ	チキンカレー風味サラダ	名詞
ちきんがーりっくふうみあげ	チキンガーリック風味揚げ	名詞
ちきんくしかつ	チキン串カツ	名詞
ちきんくりーむに	チキンクリーム煮	名詞
ちきんこーんまよやき	ちきんコーンマヨ焼き	名詞
ちきんこーんまよやき	チキンコーンマヨ焼き	名詞
ちきんすてーきおーろらそーす	チキンステーキオーロラソース	名詞
ちきんすてーきおろしぽんず	チキンステーキおろしポン酢	名詞
ちきんすてーきたるたるそーす	チキンステーキタルタルソース	名詞
ちきんすてーきどん	ちきんステーキ丼	名詞
ちきんすてーきどん	チキンステーキ丼	名詞
ちきんすてーきどんごままよ	チキンステーキ丼ゴママヨ	名詞
ちきんすてーきばたーじょうゆていしょく	ちきんステーキバター醤油定食	名詞
ちきんそてーこうみそーす	チキンソテー香味ソース	名詞
ちきんそてーさわやかそーす	チキンソテーさわやかソース	名詞
ちきんそてーらぴこっとそーす	チキンソテーラビコットソース	名詞
ちきんたつたあまずあんかけ	チキンタツタ甘酢あんかけ	名詞
ちきんたつたぴりからだれ	チキンタツタピリ辛だれ	名詞
ちきんちーずまよやき	チキンチーズマヨ焼き	名詞
ちきんちーずやき	ちきんチーズ焼き	名詞
ちきんちーずやき	チキンチーズ焼き	名詞
ちきんちゅうからびこっとそーす	チキン中華ラビコットソース	名詞
ちきんちゅうからびこっとふう	チキン中華ラビコット風	名詞
ちきんてりまよ	チキン照りマヨ	名詞
ちきんてりまよやき	チキン照りマヨ焼き	名詞
ちきんてりやき	ちきん照り焼き	名詞
ちきんてりやき	チキン照り焼き	名詞
ちきんでみかつどん	ちきんデミカツどん	名詞
ちきんとぶろっこりーのとうばんじゃんいため	チキンとブロッコリーの豆板醤炒め	名詞
ちきんとまとかれー	チキントマトカレー	名詞
ちきんとまとくりーむに	チキントマトクリーム煮	名詞
ちきんとまとまりねそーす	チキントマトマリネソース	名詞
ちきんなんばん	ちきん南蛮	名詞
ちきんなんばん	チキン南蛮	名詞
ちきんなんばんづけ	ちきん南蛮漬け	名詞
ちきんなんばんづけ	チキン南蛮漬け	名詞
ちきんぴかたかくてるそーす	チキンピカタカクテルソース	名詞
ちきんぴかたとぽてとちーずやき	チキンピカタとポテトチーズ焼き	名詞
ちきんぴざそーすやき	チキンピザソース焼	名詞
ちきんぴざそーすやき	チキンピザソース焼き	名詞
ちきんぴざとーすとやき	チキンピザトースト焼き	名詞
ちきんぴりからみそやき	チキンピリ辛味噌焼き	名詞
ちきんふれんちさらだ	チキンフレンチサラダ	名詞
ちきんぶらうんそーすに	チキンブラウンソース煮	名詞
ちきんますたーどやき	チキンマスタード焼き	名詞
ちきんまりねところっけ	チキンマリネとコロッケ	名詞
ちきんれもんぺっぱーやき	チキンレモンペッパー焼き	名詞
ちくぜんに	筑前煮	名詞
ちくわいそべあげ	ちくわ磯辺揚げ	名詞
ちくわちーずづめふらい	ちくわチーズ詰めフライ	名詞
ちくわなんばんあげ	ちくわ南蛮揚げ	名詞
ちくわのいそべあげ	ちくわの磯辺揚げ	名詞
ちくわのかれーあげ	ちくわのカレー揚げ	名詞
ちくわのちーずづめふらい	ちくわのチーズ詰めフライ	名詞
ちくわのなんばんあげ	ちくわの南蛮揚げ	名詞
ちくわのなんぶあげ	ちくわの南部揚げ	名詞
ちくわのにしきあげ	ちくわの二色揚げ	名詞
ちゃーしゅーどん	チャーシュー丼	名詞
ちゃーしゅーどん	チャーシュウ丼	名詞
ちゃーしゅうどん	チャーシュウ丼	名詞
ちゃいにーずすーぷ	チャイニーズスープ	名詞
ちゃぷちぇ	チャプチェ	名詞
ちゃんぽんふううどんとやきにくどん	ちゃんぽん風うどんと焼肉丼	名詞
ちゅうかかくにどん	中華角煮丼	名詞
ちゅうかどん	中華丼	名詞
ちゅうかふういため	中華風炒め	名詞
ちゅうかふううまに	中華風旨煮	名詞
ちゅうかふうかくに	中華風角煮丼	名詞
ちんじゃおろーすとかぼちゃころっけ	チンジャオロースとかぼちゃコロッケ	名詞
つきみねぎとろどん	月見ねぎとろ丼	名詞
つなじゃが	ツナじゃが	名詞
つなとたまねぎのおむれつ	ツナと玉ねぎのオムレツ	名詞
つなとたまねぎのおむれつ	ツナと玉ネギのオムレツ	名詞
つなまよどん	ツナマヨ丼	名詞
てりとめはんばーぐ	照りトマハンバーグ	名詞
てりまよちきん	照りマヨチキン	名詞
てりやきちきんどん	照り焼きちきん丼	名詞
てんどん	天丼	名詞
てんぷらそばとぶったまどん	天ぷらそばとぶっ玉丼	名詞
でみかつ	デミカツ	名詞
でみころっけ	デミコロッケ	名詞
でみはんばーぐ	デミハンバーグ	名詞
でみまよかつ	デミマヨカツ	名詞
でりまよどん	照りマヨ丼	名詞
とうでぶたごまどれがけ	湯で豚ゴマドレがけ	名詞
とうふすてーき	豆腐ステーキ	名詞
とうふときのこあんかけ	豆腐ときのこあんかけ	名詞
とうふとこまつさいのにびたし	豆腐と小松菜の煮浸し	名詞
とうふのきのこあんかけ	豆腐のきのこあんかけ	名詞
とかちやさいころっけ	十勝野菜コロッケ	名詞
とまととなすのかれーらいす	トマトとなすのカレーライス	名詞
とまとのはやしらいす	トマトのハヤシライス	名詞
とりからあげといかりんぐふらい	鶏唐揚げとイカリングフライ	名詞
とりからあげとまるまるまるまるまる	鶏唐揚げと○○○○○	名詞
とりからあげのあまずあんかけとやきぎょーざ	鶏唐揚げの甘酢あんかけと焼きギョーザ	名詞
とりからあげのあまずあんとやきぎょーざ	鶏唐揚げの甘酢あんと揚ギョーザ	名詞
とりからあげのあまずかんかけとあげぎょーざ	鶏唐揚げの甘酢あんかけと揚ギョーザ	名詞
とりからあげのやくみそーすあえ	鶏唐揚げの薬味ソース和え	名詞
とりからなんばんどん	鳥カラ南蛮丼	名詞
とりじゅう	鶏重	名詞
とりちり	鶏ちり	名詞
とりちりていしょく	鶏ちり定食	名詞
とりときのこのちゃーはん	鶏ときのこのチャーハン	名詞
とりにくきむちやき	鶏肉キムチ焼き	名詞
とりにくごまふうみやき	鶏肉ゴマ風味焼き	名詞
とりにくときのこのちゃーはん	鶏肉ときのこのチャーハン	名詞
とりにくとこんにゃくのぴりからに	鶏肉とこんにゃくのピリ辛煮	名詞
とりにくとさといものあげに	鶏肉と里芋の揚げ煮	名詞
とりにくとさといものにもの	鶏肉と里芋の煮物	名詞
とりにくとじゃがいものあんからめ	鶏肉とじゃが芋のあんからめ	名詞
とりにくとたけのこのうまに	鶏肉とタケノコの旨煮	名詞
とりにくとちーずやき	鶏肉とチーズ焼き	名詞
とりにくとぶろっこりーいため	鶏肉とブロッコリー炒め	名詞
とりにくとぶろっこりーのいため	鶏肉とブロッコリーの炒め	名詞
とりにくとほうれんそうのいため	鶏肉とほうれん草の炒め	名詞
とりにくとまめいたびしおあえ	鶏肉と豆板醤和え	名詞
とりにくとみそずけやき	鶏肉と味噌漬け焼き	名詞
とりにくとやさいのごめいため	鶏肉と野菜の五目炒め	名詞
とりにくとやさいのしちみいため	鶏肉と野菜の七味炒め	名詞
とりにくとやんぐこーんのまめいたびしおいため	鶏肉とヤングコーンの豆板醤炒め	名詞
とりにくのいためもの	鶏肉の炒め物	名詞
とりにくのかれーくりーむに	鶏肉のカレークリーム煮	名詞
とりにくのがーりっくやき	鶏肉のガーリック焼き	名詞
とりにくのきむちに	鶏肉のキムチ煮	名詞
とりにくのきむちやき	鶏肉のキムチ焼き	名詞
とりにくのごまてりやき	鶏肉のごま照り焼き	名詞
とりにくのごまふうみてんぷら	鶏肉のごま風味天ぷら	名詞
とりにくのさんいろあげ	鶏肉の三色揚げ	名詞
とりにくのしせんふうさらだ	鶏肉の四川風サラダ	名詞
とりにくのすぶたふう	鶏肉の酢豚風	名詞
とりにくのちーずやき	鶏肉のチーズ焼き	名詞
とりにくのちゅうかふうさらだ	鶏肉の中華風サラダ	名詞
とりにくのてりとま	鶏肉の照りトマ	名詞
とりにくのてりやきどん	鶏肉の照り焼き丼	名詞
とりにくのなんばんあげ	鶏肉の南蛮揚げ	名詞
とりにくのぴりからみそやき	鶏肉のピリ辛味噌焼き	名詞
とりにくのぴりぴりづけ	鶏肉のピリピリ漬け	名詞
とりにくのまめいたびしおあえ	鶏肉の豆板醤和え	名詞
とりにくのまめいたびしおいため	鶏肉の豆板醤炒め	名詞
とりにくのみそずけやき	鶏肉の味噌漬け焼き	名詞
とりにくぴりからみそやき	鶏肉ピリ辛味噌焼き	名詞
とりにくやくみそーすあえとあげしゅーまい	鶏肉薬味ソース和えと揚シューマイ	名詞
とりのごまてりやき	鶏肉のゴマ照り焼き	名詞
とりびきとやさいのかれーそてー	鶏挽と野菜のカレーソテー	名詞
とるこらいす	トルコライス	名詞
とろろそばとみにかつどん	とろろそばとミニカツ丼	名詞
とんじる	豚汁	名詞
とんじるやきざかなていしょく	トン汁焼き魚定食	名詞
とんたまどん	豚玉丼	名詞
とんとんていしょく	トントン定食	名詞
どらいかれー	ドライカレー	名詞
ながおかのなつやさいすーぷかれー	長岡の夏野菜スープカレー	名詞
なすととまとのきーまかれー	ナスとトマトのキーマカレー	名詞
なすのちーずはさみあげ	茄子のチーズはさみ揚げ	名詞
なすのちゅうかふううまに	茄子の中華風旨煮	名詞
なつやさいかれーらいす	夏野菜カレーライス	名詞
にいがたたれかつどん	新潟タレカツどん	名詞
にいがたもちぶたろーすどん	新潟もち豚ロース丼	名詞
にいがたもちぶたろーすにくのそてーおいすたーそーすまいたけぞえ	新潟もち豚ロース肉のソテーオイスターソース舞茸添え	名詞
にくうどんとかれーらいす	肉うどんとカレーライス	名詞
にくじゃが	肉じゃが	名詞
にくたれうどんとふったまどん	肉たれうどんとふっ玉丼	名詞
にくたれうどんとぶったまどん	肉たれうどんとぶっ玉丼	名詞
にくだんごのうまに	肉団子の旨煮	名詞
にくどうふ	肉豆腐	名詞
にこみはんばーぐ	煮込みハンバーグ	名詞
にしょくそぼうどん	二色そぼうどん	名詞
にしょくてきちゅうかどん	二食的中華丼	名詞
にしょくどん	二食丼	名詞
にひゃくぐらむのおっきなちきんすてーきどん	200グラムのおっきなチキンステーキ丼	名詞
にものもりあわせ	煮物盛り合わせ	名詞
にゅうがくおめでとうめにゅー！	入学おめでとうメニュー！	名詞
にらたまあんかけ	ニラ玉あんかけ	名詞
にらとたまごのいため	ニラと卵の炒め	名詞
にらともやしのなむる	ニラともやしのナムル	名詞
にわとりからなんばんどん	鶏カラ南蛮丼	名詞
にわとりのちりそーすどん	鶏のチリソース丼	名詞
にわとりのてりやきどん	鶏の照り焼き丼	名詞
にわとりのてりやきにおろしかけ	鶏の照り焼き煮おろしかけ	名詞
ねぎしおぶたかつ	ネギ塩豚カツ	名詞
ねぎしおぶたかるびどん	ねぎ塩豚カルビ丼	名詞
ねぎしおれいしゃぶどん	ネギ塩冷しゃぶ丼	名詞
ねぎしおれいしゃぶどん	ネギ塩冷シャブ丼	名詞
ねぎとろ	ねぎとろ	名詞
ねぎとろだいにのにしょくせいめいせんちきんなんばん	ねぎとろ・第二の生命線チキン南蛮	名詞
ねぎとろどん	ネギとろ丼	名詞
ねぎとろどん	ネギトロドン	名詞
ねぎとろどん	ネギトロ丼	名詞
ねばとろどん	ネバとろ丼	名詞
のっぺ	のっぺ	名詞
はくさいとけいびきのたまごとじ	白菜と鶏挽の卵とじ	名詞
はっしゅどびーふ	ハッシュドビーフ	名詞
はっぽうさい	八宝菜	名詞
はむ	ハム	名詞
はむちーずさいんどふらい	ハムチーズサインドフライ	名詞
はむちーずさんどふらい	ハムチーズサンドフライ	名詞
はむとほうれんそうのいため	ハムとほうれん草の炒め	名詞
はむぽてと	ハムポテト	名詞
はやしころっけらいす	ハヤシコロッケライス	名詞
はやしらいす	ハヤシライス	名詞
はるまき	春巻き	名詞
はんばーぐ	ハンバーグ	名詞
はんばーぐおろしぽんず	ハンバーグおろしポン酢	名詞
はんばーぐかれーそーす	ハンバーグカレーソース	名詞
はんばーぐきのこでみそーす	ハンバーグきのこデミソース	名詞
はんばーぐくりーみーそーす	ハンバーグクリーミーソース	名詞
はんばーぐちりそーす	ハンバーグチリソース	名詞
はんばーぐでみそーす	ハンバーグデミソース	名詞
はんばーぐでみまよ	ハンバーグデミマヨ	名詞
はんばーぐとまとにこみ	ハンバーグトマト煮込み	名詞
はんばーぐなんばんだれ	ハンバーグ南蛮ダレ	名詞
はんばーぐらいす	ハンバーグライス	名詞
はんばーぐわふうきのこそーす	ハンバーグ和風きのこソース	名詞
ばっふぁろーちきん	バッファローチキン	名詞
ばっふぁろーちきんていしょく	バッファローチキン定食	名詞
ひきにくとやさいのかれーそてー	挽肉と野菜のカレーソテー	名詞
ひとくちやきにく	一口焼肉	名詞
ひやしさんさいうどんとみにてんどん	冷やし山菜うどんとミニ天丼	名詞
ひやしてんぷらうどんとそぼろごはん	冷やし天ぷらうどんとそぼろごはん	名詞
ひやむぎもりあわせ	冷麦盛り合わせ	名詞
ひれかつ	ヒレカツ	名詞
ひれかつおろしかけ	ヒレカツおろしがけ	名詞
ひれかつそーすまよ	ヒレカツソースマヨ	名詞
ひれかつたるたるそーす	ヒレカツタルタルソース	名詞
ひれみそかつていしょく	ひれ味噌カツ定食	名詞
びーふかれーとはやしらいすのこらぼ	ビーフカレーとハヤシライスのコラボ	名詞
びっぐめんち	Bigメンチ	名詞
びびんばどん	ビビンバ丼	名詞
ぴーまんにくづめふらい	ピーマン肉詰めフライ	名詞
ぴーまんのにくづめふらい	ピーマンの肉詰めフライ	名詞
ぴざたまごところっけ	ピザ卵とコロッケ	名詞
ぴざたまごのころっけ	ピザ卵のコロッケ	名詞
ぴざばーぐとちきんそてー	ピザバーグとチキンソテー	名詞
ぴりからごめにくじゃが	ピリ辛五目肉じゃが	名詞
ぴりからみそやきちきん	ピリ辛味噌焼きチキン	名詞
ぴりからもつにこみ	ピリ辛モツ煮こみ	名詞
ふかつていしょく	麸カツ丼	名詞
ふかつどん	麩かつ丼	名詞
ふかつどん	麸かつ丼	名詞
ふからなんばん	麸カラ南蛮丼	名詞
ふくろたまごのにもの	袋卵の煮物	名詞
ふしるどん	麸しる丼	名詞
ふらいあんどふらい	フライアンドフライ	名詞
ぶたかつ	豚カツ	名詞
ぶたかつさっぱりだれ	豚カツさっぱりダレ	名詞
ぶたかつそーすまよ	豚カツソースマヨ	名詞
ぶたかつちゅうからびこっとそーす	豚カツ中華ラビコットソース	名詞
ぶたかつもみじおろし	豚カツもみじおろし	名詞
ぶたきむちいため	豚キムチ炒め	名詞
ぶたきむちちゃーはん	豚キムチチャーハン	名詞
ぶたきむちていしょく	豚キムチ定食	名詞
ぶたきむちどん	豚キムチ丼	名詞
ぶたじる	豚汁	名詞
ぶたたまどん	豚玉丼	名詞
ぶたとれもんのけちゃっぷいため	豚とレモンのケチャップ炒め	名詞
ぶたどんおんたまのせ	豚丼温玉のせ	名詞
ぶたにくがーりっくふうみやき	豚肉ガーリック風味焼き	名詞
ぶたにくきむちいため	豚肉キムチ炒め	名詞
ぶたにくきむちとちきんさらだ	豚肉キムチ炒めとチキンサラダ	名詞
ぶたにくきむちどん	豚肉キムチ丼	名詞
ぶたにくきむちやき	豚肉キムチ焼き	名詞
ぶたにくごまみそやき	豚肉ゴマ味噌焼き	名詞
ぶたにくすたみなやき	豚肉スタミナ焼き	名詞
ぶたにくすたみなやきとちきんさらだ	豚肉スタミナ焼きとチキンサラダ	名詞
ぶたにくちょうせんやき	豚肉朝鮮焼き	名詞
ぶたにくとこんにゃくのぴりからに	豚肉とこんにゃくのピリ辛煮	名詞
ぶたにくとさといものあげに	豚肉と里芋の揚げ煮	名詞
ぶたにくとせんぎりやさいいため	豚肉と千切り野菜の炒め	名詞
ぶたにくとちーずやき	豚肉とチーズ焼き	名詞
ぶたにくとちゅうかいため	豚肉と中華炒め	名詞
ぶたにくととまとのいためもの	豚肉とトマトの炒め物	名詞
ぶたにくとひれかつ	豚肉とヒレカツ	名詞
ぶたにくとやさいのからみそいため	豚肉と野菜の辛味噌炒め	名詞
ぶたにくとやさいのしちみいため	豚肉と野菜の七味炒め	名詞
ぶたにくとやさいのにこみ	豚肉と野菜の煮込み	名詞
ぶたにくとやんぐこーんのまめいたびしおいため	豚肉とヤングコーンの豆板醤炒め	名詞
ぶたにくのいためもの	豚肉の炒め物	名詞
ぶたにくのおみそちゃんちゃんやき	豚にくのお味噌ちゃんちゃん焼き	名詞
ぶたにくのおみそちゃんやき	豚肉のお味噌ちゃん焼き	名詞
ぶたにくのかれーいため	豚肉のカレー炒め	名詞
ぶたにくのきむちいため	豚肉のキムチ炒め	名詞
ぶたにくのきむちやき	豚肉のキムチ焼き	名詞
ぶたにくのごまふうみそやき	豚肉のごま風味噌焼き	名詞
ぶたにくのごまみそやき	豚肉のごま味噌焼き	名詞
ぶたにくのしょうがいため	豚肉の生姜炒め	名詞
ぶたにくのすたみないため	豚肉のスタミナ炒め	名詞
ぶたにくのすぶたふう	豚肉の酢豚風	名詞
ぶたにくのちゅうかいため	豚肉の中華炒め	名詞
ぶたにくのちょうせんやき	豚肉の挑戦焼き	名詞
ぶたにくのちょうせんやき	豚肉の朝鮮焼き	名詞
ぶたにくのぴりからどん	豚肉のピリ辛丼	名詞
ぶたにくのれいしゃぶ	豚肉の冷しゃぶ	名詞
ぶたのねぎみそいため	豚のネギみそ炒め	名詞
ぶたばらとだいこんのぴりからに	豚バラと大根のピリ辛煮	名詞
ぶたばらのとまとにこみ	豚バラのトマト煮込み	名詞
ぶたぴりからどん	豚肉ピリ辛丼	名詞
ぶたまよきゃべつたろうどん	豚マヨキャベツ太郎丼	名詞
ぶたみそどん	ブタ味噌丼	名詞
ぶろっこりーとかりふらわーのいため	ブロッコリーとカリフラワーの炒め	名詞
ぶろっこりーときのこしちゅー	ブロッコリーときのこシチュー	名詞
ぶろっこりーときのこのしちゅー	ブロッコリーときのこのシチュー	名詞
ぷちのころっけとしろみざかなふらい	プチ☆のコロッケと白身魚フライ	名詞
へるしーていしょく	ヘルシー定食	名詞
ぺっぱーちきん	ペッパーチキン	名詞
ほいこーろー	回鍋肉	名詞
ほいこーろーていしょく	回鍋肉定食	名詞
ほいこーろーとちきんさらだ	回鍋肉とチキンサラダ	名詞
ほうれんそうともやしのおひたし	ほうれん草ともやしのお浸し	名詞
ほくほくころっけ	ホクホクコロッケ	名詞
ほたてくりーむころっけといかりんぐふらい	帆立クリームコロッケとイカリングフライ	名詞
ほたてふらいたるたるそーす	ホタテフライタルタルソース	名詞
ほっかいどうさんなまさんましおやき	北海道産生さんま塩焼き	名詞
ほるもにあおうこくやきていしょく	ホルモニア王国焼き定食	名詞
ほろほろおやこどん	ほろほろ親子丼	名詞
ぼうてんふうはんばーぐ	某店風ハンバーグ	名詞
ぼくんちのぴりからもつにこみ	僕んちのピリ辛モツ煮こみ	名詞
ぽーくえっぐかれーらいす	ポークエッグカレーライス	名詞
ぽーくかれーらいす	ポークカレーライス	名詞
ぽーくさらだ	ポークサラダ	名詞
ぽーくのきむちふうさらだ	ポークのキムチ風サラダ	名詞
まーぼーたけのこ	麻婆タケノコ	名詞
まーぼーどうふ	麻婆豆腐	名詞
まーぼーどん	麻婆丼	名詞
まーぼーなす	麻婆茄子	名詞
まーぼーなすどん	麻婆茄子丼	名詞
まーぼーはるさめ	麻婆春雨	名詞
まかろにぐらたん	マカロニグラタン	名詞
まぐろのみそに	鮪の味噌煮	名詞
まさかのぎゅうやきていしょく	まさかの牛焼き定食	名詞
まるまるさんちのはんばーぐ	○○さん家のハンバーグ	名詞
みーとおむれつ	ミートオムレツ	名詞
みーとそーすやきそば	ミートソース焼きそば	名詞
みーとぼーるときゃべつそてー	ミートボールとキャベツソテー	名詞
みーとぼーるときゃべつのそてー	ミートボールとキャベツのソテー	名詞
みーとぼーるとやさいのあまずあん	ミートボールと野菜の甘酢あん	名詞
みーとぼーるのしちゅー	ミートボールのシチュー	名詞
みーどん	ミー丼	名詞
みそかつどん	みそカツ丼	名詞
みそきむちうどんとひじきごはん	味噌キムチうどんとひじきごはん	名詞
みっくすふらいどん	MIXフライ丼	名詞
みつとりあま	味付トリ天	名詞
みにぶたかつとさーもんぐりる	ミニ豚カツとサーモングリル	名詞
むししゅーまい	蒸しシューマイ	名詞
むしゅーまい	蒸シューマイ	名詞
もつかつていしょく	モツカツ定食	名詞
もつとやさいのこちゅじゃんいため	モツと野菜のコチュジャン炒め	名詞
もつとやさいのみそいため	モツと野菜の味噌炒め	名詞
もつに	モツ煮	名詞
もやしとかにのあえもの	もやしとカニの和え物	名詞
もやしときゅうりのなむる	もやしときゅうりのナムル	名詞
もやしとごまあえ	もやしとゴマ和え	名詞
もやしとはるさめのあえもの	もやしと春雨の和え物	名詞
もやしとわかめのしょうがしょうゆ	もやしとワカメの生姜醤油	名詞
もやしとわかめのしょうがじょうゆあえ	もやしとワカメの生姜醤油和え	名詞
もやしとわさびしょうゆあえ	もやしとワサビ醤油和え	名詞
もやしのあおのりあえ	もやしの青のりあえ	名詞
もやしのあおのりあえ	もやしの青のり和え	名詞
もやしのあまからいため	もやしの甘辛炒め	名詞
もやしのおひたし	もやしのお浸し	名詞
もやしのおろしあえ	もやしのおろし和え	名詞
もやしのからしあえ	もやしの辛子和え	名詞
もやしのかれーそてー	もやしのカレーソテー	名詞
もやしのごまあえ	もやしのごま和え	名詞
もやしのごまあえ	もやしのゴマ和え	名詞
もやしのごまあぶらいため	もやしのごま油炒め	名詞
もやしのごまあぶらいため	もやしのゴマ油炒め	名詞
もやしのごまずあえ	もやしのゴマ酢和え	名詞
もやしのさっぱりあえ	もやしのさっぱり和え	名詞
もやしのちゅうかあえ	もやしの中華和え	名詞
もやしのばいにくあえ	もやしの梅肉和え	名詞
もやしのゆかりあえ	もやしのゆかり和え	名詞
もやしのわさびじょうゆあえ	もやしのわさび醤油和え	名詞
もやしのわさびじょうゆあえ	もやしのワサビ醤油和え	名詞
もやしのわさびじょうゆあえ	もやしのワサビ醬油和え	名詞
やきぎょーざ	焼きギョーザ	名詞
やきぎょーざのあんかけ	焼きギョーザのあんかけ	名詞
やきさかなていしょく	焼き魚定食	名詞
やきそばとはやしらいす	焼きそばとハヤシライス	名詞
やきにく	焼肉	名詞
やきにくとあげしゅーまい	焼肉と揚シューマイ	名詞
やきにくといかりんぐふらい	焼肉とイカリングフライ	名詞
やきにくといわしうめふらい	焼肉といわし梅フライ	名詞
やきにくとそーせーじふらい	焼肉とソーセージフライ	名詞
やきにくととりからあげ	焼肉と鶏唐揚げ	名詞
やきにくとはるまき	焼肉と春巻き	名詞
やきにくとひれかつ	焼肉とヒレカツ	名詞
やきにくとぴーまんにくづめふらい	焼肉とピーマン肉詰めフライ	名詞
やきにくとぴーまんのにくづめふらい	焼肉とピーマンの肉詰めフライ	名詞
やきにくとぽてとちーずやき	焼肉とポテトチーズ焼き	名詞
やきにくとまるまるまるまるまる	焼肉と○○○○○	名詞
やきにくとみーとぼーるのあまずあん	焼肉とミートボールの甘酢あん	名詞
やきにくどん	焼肉丼	名詞
やきにくどんまよ	焼肉丼マヨ	名詞
やきにくどんみそ	焼肉丼ミソ	名詞
やきにくのごまてりやき	焼肉のゴマ照り焼き	名詞
やきにくのしせんふうさらだ	焼肉の四川風サラダ	名詞
やきにくのしょうがいため	焼肉の生姜炒め	名詞
やぎょーざ	焼ギョーザ	名詞
やさいあんかけはんばーぐ	野菜あんかけハンバーグ	名詞
やさいころっけ	野菜コロッケ	名詞
やさいてんどん	野菜天丼	名詞
やさいとみそに	野菜と味噌煮	名詞
やさいのみそに	野菜の味噌煮	名詞
ゆでたまご	ゆで卵	名詞
ゆでどりのおろしじょうゆかけ	ゆで鶏のおろし醤油かけ	名詞
ゆでぶたのおろしかけ	湯で豚のおろしかけ	名詞
ゆでぶたのごまどれがけ	湯で豚のごまドレがけ	名詞
ゆでぶたのごまどれがけ	湯で豚のゴマドレがけ	名詞
ようぎょーざ	揚ギョーザ	名詞
ようぎょーざのあんかけ	揚ギョーザのあんかけ	名詞
ようしゅーまいのすぶたふう	揚シューマイの酢豚風	名詞
ようとうふのうまに	揚豆腐の旨煮	名詞
ようとうふもみじおろしかけ	揚豆腐もみじおろしかけ	名詞
ようふうおやこどん	洋風親子丼	名詞
ようふうかくにどん	洋風角煮丼	名詞
ようふうかつ	洋風カツ	名詞
ようふうかつどん	洋風カツどん	名詞
ようふうかつどん	洋風カツ丼	名詞
ようふうみそかつていしょく	洋風味噌カツ定食	名詞
れーかーらいす	レーカーライス	名詞
れっどほっとちきん	レッドホットチキン	名詞
れっどほっとまよ	レッドほっとマヨ	名詞
れっどほっとまよ	レッドホットマヨ	名詞
ればーとぽてとのからあげ	レバーとポテトの唐揚げ	名詞
ればにらいため	レバニラ炒め	名詞
ろーすかつ	ロースカツ	名詞
ろーすぶたかつ	ロース豚カツ	名詞
ろこもこ	ロコモコ	名詞
わかめのじゃーじゃーいため	わかめのジャージャー炒め	名詞
わかめのじゃーじゃーいため	ワカメのジャージャー炒め	名詞
わふうおむれつ	和風オムレツ	名詞
わふうかれーなんばんどん	和風カレー南蛮丼	名詞
わふうちきんすてーき	和風チキンステーキ	名詞
わふうはんばーぐ	和風ハンバーグ	名詞
